11111111111111111111111111111111
1--**--**--**--**--**--**--**--1
1**--**--B*B-**--**B-B*--**--**1
1--**--B*B-B*B-**B-B*B-B*--**--1
1**--B*B-B*B-B*--B*B-B*B-B*--**1
1--**B-B*B-B*B-B*B-B*B-B*B-**--1
1**B-B*--**--B*B-**B-B*--B*B-**1
1--B*B-**B-B*B-**B-**B-**B-B*--1
1**B-B*--**B-B*--B*--B*--B*B-**1
1--B*B-**--B*B-**B-**B-**B-B*--1
1**--B*--B*B-B*--B*--B*--B*--**1
1--**B-**--**B-B*--B*B-**B-**--1
1**--**B-B*B-B*B-B*B-B*B-**--**1
1--**--B*B-B*B-B*B-B*B-B*--**--1
1**--**--B*B-B*B-B*B-B*--**--**1
1--**--**--B*B-B*B-B*--**--**--1
1**--**--**--B*B-B*--**--**--**1
1--**--**--**--B*--**--**--**--1
1**--**--**--**--**--**--**--**1
1--**--**--**--**--**--**--**--1
1**--**--**--**--**--**--**--**1
1--**--**--**--**--**--**--**--1
1**--**--**--**--**--**--**--**1
1--**--**--**--**--**--**--**--1


